const short level2_map0[50][50] = {
{ 7, 7, 7, 7, 7, 7, 7, 7, 7, 7, 7, 7, 7, 7, 7, 7, 
7, 7, 7, 7, 7, 7, 7, 7, 7, 7, 7, 7, 7, 7, 7, 7, 
7, 7, 7, 7, 7, 7, 7, 7, 7, 7, 7, 7, 7, 7, 7, 7, 
7, 7 },
{ 7, 22, 22, 22, 22, 22, 22, 22, 22, 22, 22, 22, 22, 22, 22, 22, 
22, 22, 22, 22, 22, 22, 22, 22, 22, 22, 22, 22, 22, 22, 22, 22, 
22, 22, 22, 13, 14, 22, 22, 22, 22, 22, 22, 22, 22, 22, 22, 22, 
15, 7 },
{ 7, 22, 22, 22, 22, 22, 22, 22, 22, 22, 22, 22, 22, 22, 22, 22, 
22, 22, 22, 22, 22, 22, 22, 22, 22, 22, 22, 22, 22, 22, 22, 22, 
22, 22, 13, 14, 22, 22, 22, 22, 22, 22, 22, 22, 22, 22, 22, 22, 
22, 7 },
{ 7, 22, 22, 22, 22, 22, 22, 22, 22, 22, 22, 22, 22, 22, 22, 22, 
22, 22, 22, 22, 22, 22, 22, 22, 22, 22, 22, 22, 22, 22, 22, 22, 
22, 13, 14, 22, 22, 22, 22, 22, 22, 22, 22, 22, 22, 22, 22, 22, 
22, 7 },
{ 7, 22, 22, 22, 22, 22, 22, 22, 22, 22, 22, 22, 22, 22, 22, 22, 
22, 22, 22, 22, 22, 22, 22, 22, 22, 22, 22, 22, 22, 22, 22, 22, 
13, 14, 22, 22, 22, 22, 22, 22, 22, 22, 22, 22, 22, 22, 22, 22, 
22, 7 },
{ 7, 22, 22, 22, 22, 22, 22, 22, 22, 22, 22, 22, 22, 22, 22, 22, 
22, 22, 22, 22, 22, 22, 22, 22, 22, 22, 22, 22, 22, 22, 22, 22, 
7, 22, 22, 22, 22, 22, 22, 22, 22, 22, 22, 22, 22, 22, 22, 22, 
22, 7 },
{ 7, 22, 22, 22, 22, 22, 22, 22, 22, 22, 22, 22, 22, 22, 22, 22, 
22, 22, 22, 22, 22, 22, 22, 22, 22, 22, 22, 22, 22, 22, 22, 22, 
7, 22, 22, 22, 22, 22, 22, 22, 22, 22, 22, 22, 22, 22, 22, 22, 
22, 7 },
{ 7, 22, 22, 22, 22, 22, 22, 22, 22, 22, 22, 22, 22, 22, 22, 22, 
22, 22, 22, 22, 22, 22, 22, 22, 22, 22, 22, 22, 22, 22, 22, 22, 
7, 22, 22, 22, 22, 22, 22, 22, 22, 22, 22, 22, 22, 22, 22, 22, 
22, 7 },
{ 7, 22, 22, 22, 22, 22, 22, 22, 22, 22, 22, 22, 22, 22, 22, 22, 
22, 22, 22, 22, 22, 22, 22, 22, 22, 22, 22, 22, 22, 22, 22, 22, 
7, 22, 22, 22, 22, 22, 22, 22, 7, 22, 22, 22, 22, 22, 22, 22, 
22, 7 },
{ 7, 22, 22, 22, 22, 22, 22, 22, 22, 22, 22, 22, 22, 22, 22, 22, 
22, 22, 22, 22, 22, 22, 22, 22, 22, 22, 22, 22, 22, 22, 22, 22, 
7, 22, 22, 22, 22, 22, 22, 22, 7, 22, 22, 22, 22, 22, 22, 22, 
22, 7 },
{ 7, 22, 22, 22, 22, 22, 22, 22, 22, 22, 22, 22, 22, 22, 22, 22, 
22, 22, 22, 22, 22, 22, 22, 22, 22, 22, 22, 22, 22, 22, 22, 22, 
7, 22, 22, 22, 22, 22, 22, 22, 7, 22, 22, 22, 22, 22, 22, 22, 
22, 7 },
{ 7, 22, 22, 22, 22, 22, 22, 22, 22, 22, 22, 22, 22, 22, 22, 22, 
22, 22, 22, 22, 22, 22, 22, 22, 22, 22, 22, 22, 22, 22, 22, 22, 
7, 22, 22, 22, 22, 22, 22, 22, 7, 22, 22, 22, 22, 22, 22, 22, 
22, 7 },
{ 7, 22, 22, 22, 22, 22, 22, 22, 22, 22, 22, 22, 22, 22, 22, 22, 
22, 22, 22, 22, 22, 22, 22, 22, 22, 22, 22, 22, 22, 22, 22, 22, 
7, 22, 22, 22, 22, 22, 22, 22, 7, 22, 22, 22, 22, 22, 22, 22, 
22, 7 },
{ 7, 22, 22, 22, 22, 22, 22, 22, 22, 22, 22, 22, 22, 22, 22, 22, 
22, 22, 22, 22, 22, 22, 22, 22, 22, 22, 22, 22, 22, 22, 22, 22, 
7, 22, 22, 22, 22, 22, 22, 22, 7, 22, 22, 22, 22, 22, 22, 22, 
22, 7 },
{ 7, 22, 22, 22, 22, 22, 22, 22, 22, 22, 22, 22, 22, 22, 22, 22, 
13, 7, 7, 7, 7, 7, 7, 7, 12, 22, 22, 22, 22, 22, 22, 22, 
7, 22, 22, 22, 22, 22, 22, 22, 7, 22, 22, 22, 22, 22, 22, 22, 
22, 7 },
{ 7, 22, 22, 22, 22, 22, 22, 22, 22, 22, 22, 22, 22, 22, 22, 13, 
14, 22, 22, 22, 22, 22, 22, 22, 15, 12, 22, 22, 22, 22, 22, 22, 
7, 22, 22, 22, 22, 22, 22, 22, 7, 22, 22, 22, 22, 22, 22, 22, 
22, 7 },
{ 7, 22, 22, 22, 22, 22, 22, 22, 22, 22, 22, 22, 22, 22, 13, 14, 
22, 22, 22, 22, 22, 22, 22, 22, 22, 15, 12, 22, 22, 22, 22, 22, 
7, 22, 22, 22, 22, 22, 22, 22, 7, 22, 22, 22, 22, 22, 22, 22, 
22, 7 },
{ 7, 22, 22, 22, 22, 22, 22, 22, 22, 22, 22, 22, 22, 13, 14, 22, 
22, 22, 22, 22, 22, 22, 22, 22, 22, 22, 7, 22, 22, 22, 22, 22, 
15, 12, 22, 22, 22, 22, 22, 22, 7, 22, 22, 22, 22, 22, 22, 22, 
22, 7 },
{ 7, 22, 22, 22, 22, 22, 22, 22, 22, 22, 22, 22, 13, 14, 22, 22, 
22, 22, 22, 22, 22, 22, 22, 22, 22, 22, 7, 22, 22, 22, 22, 22, 
22, 15, 12, 22, 22, 22, 22, 22, 7, 22, 22, 22, 22, 22, 22, 22, 
22, 7 },
{ 7, 22, 22, 22, 22, 22, 22, 22, 22, 22, 22, 13, 14, 22, 22, 22, 
22, 22, 22, 22, 22, 22, 22, 22, 22, 22, 7, 22, 22, 22, 22, 22, 
22, 22, 15, 22, 22, 22, 22, 22, 7, 22, 22, 22, 22, 22, 22, 22, 
22, 7 },
{ 7, 7, 7, 7, 7, 7, 7, 7, 7, 7, 7, 7, 22, 22, 22, 22, 
22, 22, 22, 22, 22, 22, 22, 22, 22, 22, 7, 22, 22, 22, 22, 22, 
22, 22, 22, 22, 22, 22, 22, 22, 7, 22, 22, 22, 22, 22, 22, 22, 
22, 7 },
{ 7, 7, 7, 7, 7, 7, 7, 7, 7, 7, 7, 14, 22, 22, 22, 22, 
22, 22, 22, 13, 22, 22, 22, 22, 22, 22, 15, 12, 22, 22, 22, 22, 
22, 22, 22, 22, 22, 22, 22, 22, 7, 22, 22, 22, 22, 22, 22, 22, 
22, 7 },
{ 7, 14, 22, 22, 22, 22, 22, 22, 22, 22, 22, 22, 22, 22, 22, 22, 
22, 22, 13, 7, 22, 22, 22, 22, 22, 22, 22, 15, 12, 22, 22, 22, 
22, 22, 22, 22, 22, 22, 22, 22, 7, 22, 22, 22, 22, 22, 22, 22, 
22, 7 },
{ 7, 22, 22, 22, 22, 22, 22, 22, 22, 22, 22, 22, 22, 22, 22, 22, 
22, 13, 14, 15, 12, 22, 22, 22, 22, 22, 22, 22, 15, 12, 22, 22, 
22, 22, 22, 22, 22, 22, 22, 22, 7, 22, 22, 22, 22, 22, 22, 22, 
22, 7 },
{ 7, 22, 22, 22, 22, 22, 22, 22, 22, 22, 22, 22, 22, 22, 22, 22, 
13, 14, 22, 22, 15, 12, 22, 22, 22, 22, 22, 22, 22, 15, 12, 22, 
22, 22, 22, 22, 22, 22, 22, 22, 7, 22, 22, 22, 22, 22, 22, 22, 
22, 7 },
{ 7, 22, 22, 22, 22, 22, 22, 22, 22, 22, 22, 22, 22, 22, 22, 13, 
14, 22, 22, 5, 22, 15, 12, 22, 22, 22, 22, 22, 22, 22, 15, 12, 
22, 22, 22, 22, 22, 22, 22, 22, 7, 22, 22, 22, 22, 22, 22, 22, 
22, 7 },
{ 7, 22, 22, 22, 22, 22, 22, 22, 13, 7, 7, 7, 7, 12, 13, 14, 
22, 22, 22, 22, 22, 22, 15, 12, 22, 22, 22, 22, 22, 22, 22, 15, 
12, 22, 22, 22, 22, 22, 22, 22, 7, 22, 22, 22, 22, 22, 22, 22, 
22, 7 },
{ 7, 22, 22, 22, 22, 22, 22, 22, 15, 7, 7, 7, 7, 14, 22, 22, 
22, 22, 22, 22, 22, 22, 22, 15, 12, 22, 22, 22, 22, 22, 22, 22, 
15, 12, 22, 22, 22, 22, 22, 22, 7, 22, 22, 22, 22, 22, 22, 22, 
22, 7 },
{ 7, 22, 22, 22, 22, 22, 22, 22, 22, 22, 22, 22, 22, 22, 22, 22, 
22, 22, 22, 22, 22, 22, 22, 22, 15, 12, 22, 22, 22, 22, 22, 22, 
22, 15, 12, 22, 22, 22, 22, 22, 7, 22, 22, 22, 22, 22, 22, 22, 
22, 7 },
{ 7, 22, 22, 22, 22, 22, 22, 22, 22, 22, 22, 22, 22, 22, 22, 22, 
22, 22, 22, 22, 22, 22, 22, 22, 22, 7, 12, 22, 22, 22, 22, 22, 
22, 22, 15, 12, 22, 22, 22, 22, 7, 22, 22, 22, 22, 22, 22, 22, 
22, 7 },
{ 7, 22, 22, 22, 22, 22, 22, 22, 22, 22, 22, 22, 22, 22, 22, 22, 
22, 22, 22, 22, 22, 22, 22, 22, 13, 14, 15, 12, 22, 22, 22, 22, 
22, 22, 22, 15, 12, 22, 22, 22, 7, 22, 22, 22, 22, 22, 22, 22, 
22, 7 },
{ 7, 22, 22, 22, 22, 22, 22, 22, 22, 22, 22, 22, 22, 22, 22, 22, 
22, 22, 22, 22, 22, 22, 22, 13, 14, 22, 22, 15, 12, 22, 22, 22, 
22, 22, 22, 22, 15, 12, 22, 22, 7, 22, 22, 22, 22, 22, 22, 22, 
22, 7 },
{ 7, 22, 22, 22, 22, 22, 22, 22, 22, 22, 22, 22, 22, 22, 22, 22, 
22, 22, 22, 22, 22, 22, 13, 14, 22, 22, 22, 22, 15, 12, 22, 22, 
22, 22, 22, 22, 22, 15, 12, 22, 7, 22, 22, 22, 22, 22, 22, 22, 
22, 7 },
{ 7, 12, 22, 22, 22, 22, 22, 22, 22, 22, 22, 22, 22, 22, 22, 22, 
22, 22, 22, 22, 22, 13, 14, 22, 22, 22, 22, 22, 22, 15, 12, 22, 
22, 22, 22, 22, 22, 22, 15, 12, 7, 22, 22, 22, 22, 22, 22, 22, 
22, 7 },
{ 7, 7, 7, 7, 7, 7, 7, 7, 7, 12, 22, 22, 22, 22, 22, 22, 
22, 22, 22, 22, 13, 14, 22, 22, 22, 22, 22, 22, 22, 22, 15, 12, 
22, 22, 22, 22, 22, 22, 22, 15, 7, 22, 22, 22, 22, 22, 22, 22, 
22, 7 },
{ 7, 7, 7, 7, 7, 7, 7, 7, 7, 14, 22, 22, 22, 22, 22, 22, 
22, 22, 22, 13, 14, 22, 22, 22, 22, 22, 22, 22, 22, 22, 22, 15, 
12, 22, 22, 22, 22, 22, 22, 22, 7, 22, 22, 22, 22, 22, 22, 22, 
22, 7 },
{ 7, 22, 22, 22, 22, 22, 22, 22, 22, 22, 22, 22, 22, 22, 22, 22, 
22, 22, 22, 7, 22, 22, 22, 22, 22, 22, 22, 22, 22, 22, 22, 22, 
15, 12, 22, 22, 22, 22, 22, 22, 7, 22, 22, 22, 22, 22, 22, 22, 
22, 7 },
{ 7, 22, 22, 22, 22, 22, 22, 22, 22, 22, 22, 22, 22, 22, 22, 22, 
22, 22, 22, 7, 22, 22, 22, 22, 22, 22, 22, 22, 22, 22, 22, 22, 
22, 7, 22, 22, 22, 22, 22, 22, 7, 22, 22, 22, 22, 22, 22, 22, 
22, 7 },
{ 7, 22, 22, 22, 22, 22, 22, 22, 22, 22, 22, 22, 22, 22, 22, 22, 
22, 22, 22, 7, 22, 22, 22, 22, 22, 22, 22, 22, 22, 22, 22, 22, 
22, 7, 22, 22, 22, 22, 22, 22, 7, 22, 22, 22, 22, 22, 22, 22, 
22, 7 },
{ 7, 22, 22, 22, 22, 22, 22, 22, 22, 22, 22, 22, 22, 22, 22, 22, 
22, 22, 22, 7, 22, 22, 22, 22, 22, 13, 12, 22, 22, 22, 22, 22, 
22, 7, 22, 22, 22, 22, 22, 22, 7, 22, 22, 22, 22, 22, 22, 22, 
22, 7 },
{ 7, 22, 22, 22, 22, 22, 22, 22, 22, 22, 22, 22, 22, 22, 22, 22, 
22, 22, 22, 7, 22, 22, 22, 22, 22, 7, 7, 22, 22, 22, 22, 22, 
22, 7, 22, 22, 22, 22, 22, 22, 7, 22, 22, 22, 22, 22, 22, 22, 
22, 7 },
{ 7, 22, 22, 22, 22, 22, 22, 22, 13, 7, 7, 7, 7, 12, 13, 12, 
13, 12, 13, 14, 22, 22, 22, 22, 22, 7, 7, 22, 22, 22, 22, 22, 
22, 7, 22, 22, 22, 22, 22, 22, 7, 22, 22, 22, 22, 22, 22, 22, 
22, 7 },
{ 7, 22, 22, 22, 22, 22, 22, 22, 15, 7, 7, 7, 7, 14, 15, 14, 
15, 14, 22, 22, 22, 22, 22, 22, 22, 7, 7, 22, 22, 22, 22, 22, 
22, 7, 22, 22, 22, 22, 22, 22, 14, 22, 22, 22, 22, 22, 22, 22, 
22, 7 },
{ 7, 22, 22, 22, 22, 22, 22, 22, 22, 22, 22, 22, 22, 22, 22, 22, 
22, 22, 22, 22, 22, 22, 22, 22, 22, 7, 7, 22, 22, 22, 22, 22, 
22, 7, 22, 22, 22, 22, 22, 22, 22, 22, 22, 22, 22, 22, 22, 22, 
22, 7 },
{ 7, 22, 22, 22, 22, 22, 22, 22, 22, 22, 22, 22, 22, 22, 22, 22, 
22, 22, 22, 22, 22, 22, 22, 22, 22, 7, 7, 22, 22, 22, 22, 22, 
22, 7, 22, 22, 22, 22, 22, 22, 22, 22, 22, 22, 22, 22, 22, 22, 
22, 7 },
{ 7, 22, 22, 22, 22, 22, 22, 22, 22, 22, 22, 22, 22, 22, 22, 22, 
22, 22, 22, 22, 22, 22, 22, 22, 22, 7, 7, 22, 22, 22, 22, 22, 
22, 7, 22, 22, 22, 22, 22, 22, 22, 22, 22, 22, 22, 22, 22, 22, 
22, 7 },
{ 7, 22, 22, 22, 22, 22, 22, 22, 22, 22, 22, 22, 22, 22, 22, 22, 
22, 22, 22, 22, 22, 22, 22, 22, 22, 7, 7, 22, 22, 22, 22, 22, 
22, 7, 22, 22, 22, 22, 22, 22, 22, 22, 22, 22, 22, 22, 22, 22, 
22, 7 },
{ 7, 22, 22, 22, 22, 22, 22, 22, 22, 22, 22, 22, 22, 22, 22, 22, 
22, 22, 22, 22, 22, 22, 22, 22, 22, 7, 7, 22, 22, 22, 22, 22, 
22, 7, 22, 22, 22, 22, 22, 22, 22, 22, 22, 22, 22, 22, 22, 22, 
22, 7 },
{ 7, 12, 22, 22, 22, 22, 22, 22, 22, 22, 22, 22, 22, 22, 22, 22, 
22, 22, 22, 22, 22, 22, 22, 22, 13, 7, 7, 12, 22, 22, 1, 22, 
13, 7, 12, 22, 22, 22, 22, 22, 22, 22, 22, 22, 22, 22, 22, 22, 
13, 7 },
{ 7, 7, 7, 7, 7, 7, 7, 7, 7, 7, 7, 7, 7, 7, 7, 7, 
7, 7, 7, 7, 7, 7, 7, 7, 7, 7, 7, 7, 7, 7, 7, 7, 
7, 7, 7, 7, 7, 7, 7, 7, 7, 7, 7, 7, 7, 7, 7, 7, 
7, 7 }
};

const unsigned short level2_cmap[256] = {
0x0000, 0x01E0, 0x0013, 0x11CC, 0x0000, 0x0000, 0x0000, 0x0000,
0x0000, 0x0000, 0x0000, 0x0000, 0x0000, 0x0000, 0x0000, 0x0000,
0x0000, 0x0000, 0x0000, 0x0000, 0x6008, 0x0010, 0x0000, 0x0000,
0x0000, 0x0000, 0x0000, 0x0000, 0x0001, 0x0020, 0x0C00, 0x0000,
0x0000, 0x0000, 0x0000, 0x0000, 0x0000, 0x0BC0, 0x6F21, 0x03FC,
0x0012, 0x0040, 0x0400, 0x0000, 0x0000, 0x0000, 0x0000, 0x0000,
0x0000, 0x0000, 0x0000, 0x0000, 0x0000, 0x0000, 0x0000, 0x0000,
0x0000, 0x0000, 0x0C00, 0x0000, 0x0000, 0x0060, 0x2C00, 0x0000,
0x0018, 0x00E0, 0x0C00, 0x0000, 0x000E, 0x02E0, 0x1800, 0x0000,
0x0003, 0x01C0, 0x5C00, 0x0000, 0x0006, 0x0060, 0x3800, 0x0000,
0x0017, 0x00C0, 0x0C00, 0x0000, 0x000E, 0x02E0, 0x3800, 0x0000,
0x0003, 0x0160, 0x6000, 0x0000, 0x000E, 0x0060, 0x3800, 0x0000,
0x0003, 0x00C0, 0x5C00, 0x0000, 0x000E, 0x0300, 0x1800, 0x0000,
0x0003, 0x00C0, 0x6000, 0x0000, 0x0007, 0x0080, 0x3000, 0x0000,
0x0017, 0x01C0, 0x0000, 0x0000, 0x0000, 0x0000, 0x0000, 0x0000,
0x0000, 0x0000, 0x0000, 0x0000, 0x0000, 0x0000, 0x0000, 0x0000,
0x0000, 0x0000, 0x0000, 0x0000, 0x0000, 0x0000, 0x0000, 0x0000,
0x0000, 0x0000, 0x0000, 0x0000, 0x0000, 0x0000, 0x0000, 0x0000,
0x0000, 0x0000, 0x0000, 0x0000, 0x0000, 0x0000, 0x0000, 0x0000,
0x0000, 0x0000, 0x0000, 0x0000, 0x0000, 0x0000, 0x0000, 0x0000,
0x0000, 0x0000, 0x0000, 0x0000, 0x0000, 0x0000, 0x0000, 0x0000,
0x0000, 0x0000, 0x0000, 0x0000, 0x0000, 0x0000, 0x0000, 0x0000,
0x0000, 0x0000, 0x0000, 0x0000, 0x0000, 0x0000, 0x0000, 0x0000,
0x0000, 0x0000, 0x0000, 0x0000, 0x0000, 0x0000, 0x0000, 0x0000,
0x0000, 0x0000, 0x0000, 0x0000, 0x0000, 0x02A0, 0x7000, 0x0000,
0x0000, 0x0060, 0x5000, 0x0000, 0x001B, 0x0000, 0x0C00, 0x0000,
0x0014, 0x0360, 0x0000, 0x0000, 0x0003, 0x0280, 0x6C00, 0x0000,
0x0000, 0x0060, 0x5000, 0x0000, 0x0003, 0x0000, 0x0000, 0x0000,
0x0015, 0x0060, 0x0000, 0x0000, 0x0003, 0x0000, 0x6C00, 0x0000,
0x0014, 0x0060, 0x5400, 0x0000, 0x001B, 0x0000, 0x6C00, 0x0000,
0x0015, 0x0380, 0x0400, 0x0000, 0x0001, 0x0280, 0x0C00, 0x0000,
0x7FFC, 0x7EBF, 0x73FF, 0x7FFF, 0x7FF5, 0x7F9F, 0x57FF, 0x7FFF
};

